1111111111111111111
1C000011110C00P0001
10111000000C0111101
1000111111110111101
1110110010000000011
1C001C0000000E100C1
1111111111111111111