1111111111111111111
1C000011111C0000001
10111000000C011P101
1000111111110111100
1110110000000E10001
1C000C000100011C001
1111111111111111111