1111111111111111111
1C000011111C0000001
10111000000C011P101
1000111111110111101
1110110010000E10011
1C001C0001000110001
1111111111111111111