1111111111111111111
1C000011111C00E0001
10111000000C0111101
1000111111110111101
1110110010000010011
1P001C0001000110001
1111111111111111111