1111111111111111111
1C00001111C000C0001
10111P0000000111101
1000111111110111101
111011111100E1C0001
10001C0000000110001
1111111111111111111