1111111111111111111
1000001111100000001
101110000000011P101
1000111111110111101
1110110000000E10001
1000000001000110001
1111111111111111111