1111111111111111111
1C000111110C00P0001
10111000000C0111101
1000111111110111101
1110110010000010011
10001C0001000E10001
1111111111111111111