1111111111111111111
1C000011111C00E0001
10111000000C0111101
1000111111110111101
111011000000001C101
1P001C0001000110001
1111111111111111111